11111111111111111111111111111
10000000000000000001101000001
10000000000000000000000000001
1000C000000000000000010000001
100C0000100000000000000000001
1000000000000C000000000000C01
10000000000000000000000000001
1000000000000000000C000000001
10000000E000000000P0000000001
10000000000001000000000000001
10000000000000000000000000001
1000000C000000000100000000001
1000000C000010000000000000001
100000000C0001000000001000001
10000000001000000000000000001
11111111111111111111111111111