111111111111
1000C0001111
10P0C0001111
1000C0001111
10100C010011
1000C0E01111
10110C011101
111111111111
