111111111111
1000C0001111
10P0C0001111
1000C0001111
10100C010011
100001E01111
10110C111101
111111111111
