111111111111
1000C0001001
100C00000E01
10100C0100P1
10000C000001
111111111111
