1111111111111111111111111111111111111111111111111111111111111111111111111111111111111111111111111111111111111111111111111111111111111111
100000C00000000000000C000000000000000000000000000000000000000000000000000000000000000000C0000000000000000000000CC00000000000000000000001
100000C00000000000000C000000000000000000000000000000000000000000000000000000000000000000C0000000000000000000000CC00000000000000000000001
100000C00000000000000C000000000000000000000000000000000000000000000000000000000000000000C0000000000000000000000CC00000000000000000000001
100000C00000000000000C000000000000000000000000000000000000000000000000000000000000000000C0000000000000000000000CC00000000000000000000001
10000000000000000C000C00000000000000000E000000000000000000000000000000000000000000000000C0000000000000000000000CC00000000000000000000001
100000C00000000000000C000000000000000000000000000000000C00000000000000000000000000000000C0000000000000000000000CC00000000000000000000001
100000C00000000000000C0000000000000000000000000000000000C00000000000000000000000000000000C0000000000000000000000CC0000000000000000000001
100000C000000000C00000C0000000000000C00000000000000000000000000000000000000000000000000000C0000000000000000000000CC000000000000000000001
100000C00000000000000C000000000000000000C000000000000000000000000000000000000000000000000C0000000000000000000000CC0000000000000000000001
100000C00000000000000C000000000000000000000C000000000000000000000000000000000000000000000C0000000000000000000000CC0000000000000000000001
100000C00000000000000C00000000000000000000000000C0000000000000000000000000000000000000000C0000000000000000000000CC00000000000CC00C000001
100000C00000000000000C00000000000000000000000000000000CC0000000000000000000000000000000000C0000000000000000000000CC00000000CCC0000000001
100000C00000000000000C000000000000000000000000000000000000000000000000000000000000000000C0000000000000000000000CC00000000000000000000001
100000C00000000000000C000000000000000000000000000000000000000000000000000000000000000000C0000000000000000000000CC00000000000000000000001
100000C00000000000000C00000000000000000000000000000000C0000000000000000000000000000000000C0000000000000000000000CC0000000000000000000001
100000C00000000000000C000000000000000000000000P00000000000000000000000000000000000000000C0000000000000000000000CC00000000000000000000001
100000C00000000000000C00000000000000000000000000000000C00000000000000000000000CCC00000000000C0000000000000000000000CC0000000000000000001
100000C00000000000000C0000000000000000000000000000000000C00000000000000000000000000000000C0000000000000000000000CC0000000000000000000001
100000C00000000000000C000000000000000000000000000000000000000000000000000000000000000000C0000000000000000000000CC00000000000000000000001
100000C00000000000000C000000000000000CCCC00000000000000000000000000000000CCCCC0000000000000000000C0000000000000000000000CC00000000000001
100000C00000000000000C00000000000000000000000000000000000CCC000000000000000000000000000000C0000000000000000000000CC000000000000000000001
1111111111111111111111111111111111111111111111111111111111111111111111111111111111111111111111111111111111111111111111111111111111111111