11111111111111111
1000000000C000001
1000C0000000P0001
10001111000000001
10001E01000000001
11111111111111111