111111111111111111
1P0C01000010000001
100000000010000101
111111111111111111